. . . . . . . . . . . . . . . . . . . . . . . . . . . . . . . .
. . . . . . . . . . . . . . . . . . . . . . . . . . . . . . . .
. . . . . . . . . . . . . . . . . . . . . . . . . . . . . . . .
. . . . . . . . . . . . . . . . . . . . . . . . . . . . . . . .
. . . . . . . . . . . . . . . . . . . . . . . . . . . . . . . .
. . . . . . . . . . . . . . . . . . . . . . . . . . . . . . . .
. . . . . . . . . . . . . . . . . . . . . . . . . . . . . . . .
. . . . . . . . . . . . . . . . . . . . . . . . . . . . . . . .
. . . . . . . . . . . . . . . . . . . . . . . . . . . . . . . .
. . . . . . . . . . . . . . . . . . . . . . . . . . . . . . . .
. . . . . . . . . . . . . . . . . . . . . . . . . . . . . . . .
. . . . . . . . . . . . . . . . . . . . . . . . . . . . . . . .
1 1 1 2 . . . . . . . . . . . . . . . . . . . . . . . . 0 1 1 1
, , , 4 . . . . . . . . . d e e e e f . . . . . . . . . 3 , , ,
, , , 4 . . . . . . . . . . . . . . . . . . . . . . . . 3 , , ,
, , , 4 . . . . . . . . . . . . . . . . . . . . . . . . 3 , , ,
, , , 8 1 1 1 2 . . . . . . . . . . . . . . . . 0 1 1 1 9 , , ,
, , , , , , , 4 . . . . . . . . . . . . . . . . 3 , , , , , , ,
, , , , , , , 4 . . . . . . . . . . . . . . . . 3 , , , , , , ,
, , , , , , , 4 . . . . . . . . . . . . . . . . 3 , , , , , , ,
, , , , , , , 8 1 1 1 1 1 1 1 1 1 1 1 1 1 1 1 1 9 , , , , , , ,
, , , , , , , , , , , , , , , , , , , , , , , , , , , , , , , ,
, , , , , , , , , , , , , , , , , , , , , , , , , , , , , , , ,
, , , , , , , , , , , , , , , , , , , , , , , , , , , , , , , ,